{
  "ERY": "1000000000",
  "SM":  "0100000000",
  "LIN": "0010000000",
  "SPM": "0001000000",
  "PG":  "0000100000",
  "GEN": "0000010000",
  "TC":  "0000001000",
  "CEP": "0000000100",
  "OTC": "0000000010",
  "SPC": "0000000001"
}
